. . B B B C
. . D . . C
A A D . . C
. . . . . .
. . E E G G
. . . . . .
