. . B . . .
. . B . . .
A A B . . .
C C C . . D
. . . . . D
. . . . . D