. . . G K K
. . . G . J
A A . E F J
. . . E F J
B C C C D .
B . . . D .
