. . . . . .
. . . . . .
A A . B . .
C C . B D .
. E . B D .
. E F F D .