. . B . . .
. . B . . .
A A B . . H
. C . . E H
. C D D E .
. . . . E .
