. . . . J C
. . D D J C
. . A A G C
. . E . G .
. . E H F F
. . E H . .
