. . B . . .
. . B . . .
A A B . . .
. . . . C .
. D E E C .
. D . . C .